0 0 0 0 1 1 1 1 1 1
0 312 0 0 0 1 1 1 700031 1
0 0 0 0 0 1 1 1 1 1
0 0 0 0 0 1 1 1 1 1
20 0 0 0 0 0 0 0 0 200020
0 0 0 210 0 0 0 0 0 0
0 0 0 0 0 0 0 0 0 0
0 0 410 0 0 0 0 410030 0 0
0 0 0 0 0 0 0 0 0 110
0 800030 0 0 0 0 0 0 0 800020