2 0 0 1 1 1 1 1 1 1
0 310 0 1 1 1 1 1 700031 1
0 0 0 1 1 1 1 1 1 1
1 1 1 1 1 1 1 1 1 1
600021 1 1 1 1 1 1 1 1 200021
1 1 1 211 1 1 1 1 1 1
1 1 1 1 1 1 1 1 1 1
1 1 411 1 1 1 1 410031 1 1
1 1 1 1 1 1 1 1 1 111
1 800031 1 1 1 1 1 1 1 800021